Lista dos Estados com WebServices Próprios
    Amazonas - AM			
	Bahia - BA
	Ceará - CE
	Distrito Federal - DF
	Espirito Santo - ES		(Não foi incluido ainda no UniNFE)
	Goias - GO
	Minas Gerais - MG
	Mato Grosso do Sul - MS
	Mato Grosso - MT
	Pernambuco - PE
	Paraná - PR
	Rondônia - RO
	Rio Grande do Sul - RS
	São Paulo - SP			

Lista dos Estados que utilizam os WebServices do Ambiente Virtual Nacional
    Maranhão - MA
    Pará - PA
    Piauí - PI
    Rio Grande do Norte - RN

Lista dos Estados que utilizam os WebServices do Ambiente Virtual do Rio Grande do Sul  
	Acré - AC
	Alagoas - AL
	Amapá - AP
	Paraíba - PB
	Rio de Janeiro - RJ
	Roraima - RR
	Santa Catarina - SC
	Sergipe - SE
	Tocantins - TO    